1	1	1	1	1	1	1	1	1	1	1	1	1	1	1	1	1	1	1	1	1	1
1	2	0	0	0	0	0	0	0	0	6	3	1	0	0	0	0	5	1	6	3	1
1	1	1	0	1	1	1	1	1	1	1	1	1	0	1	1	1	1	1	0	1	1
1	0	0	0	3	1	0	0	0	0	0	0	0	0	0	0	0	0	0	0	5	1
1	6	1	1	1	1	0	1	1	1	1	1	1	0	1	0	1	1	1	1	1	1
1	0	0	0	0	1	0	0	0	0	1	0	1	0	1	0	1	0	0	6	3	1
1	1	1	1	0	0	0	1	1	0	1	0	0	0	1	0	1	0	1	1	1	1
1	6	3	1	1	1	0	1	1	0	1	0	1	0	1	0	1	0	0	0	0	1
1	0	1	1	0	0	0	0	0	0	0	0	1	0	0	0	1	1	1	1	0	1
1	0	0	0	0	1	1	1	1	0	1	1	1	1	1	0	0	0	0	0	0	1
1	0	1	1	1	1	0	0	6	0	0	0	0	0	1	1	1	1	1	1	1	1
1	0	0	0	0	1	0	1	3	1	1	0	1	6	0	0	0	6	3	1	3	1
1	1	1	1	0	1	0	1	1	1	1	0	1	0	1	0	1	1	1	1	6	1
1	5	5	5	0	1	0	1	3	6	1	0	1	3	1	0	0	0	0	0	0	1
1	1	1	1	0	1	1	1	1	0	1	0	1	1	1	1	0	1	1	1	1	1
1	1	1	1	0	1	5	5	1	0	1	0	0	0	1	1	0	1	0	1	3	1
1	0	0	0	0	1	1	0	0	0	0	0	1	0	0	0	0	0	0	1	6	1
1	0	1	1	1	1	1	1	1	1	1	0	1	1	1	0	1	1	0	0	0	1
1	0	1	3	1	1	0	0	0	0	0	0	0	0	0	0	1	1	1	1	1	1
1	6	1	6	1	1	0	1	1	1	1	1	1	1	1	0	1	0	0	0	0	1
1	3	1	0	0	0	0	0	5	5	5	5	5	5	0	0	0	0	1	1	4	1
1	1	1	1	1	1	1	1	1	1	1	1	1	1	1	1	1	1	1	1	1	1